交易所代码：
'XINE':'上海国际能源交易中心',
 'XSGE':'上海期货交易所',
 'XZCE':'郑州商品交易所', 
'XDCE':'大连商品交易所',
'CCFX':'中国金融期货交易所'

品种代码：
IC : 中证500
IF : 沪深300
IH : 上证50
T : 10年期国债
TF : 5年期国债
TS : 2年期国债
SC : 原油
NR : 20号胶
LU : 低硫燃料油
AG : 白银
AL : 铝
AU : 黄金
BU : 石油沥青
CU : 铜
FU : 燃料油
HC : 热轧卷板
NI : 镍
PB : 铅
RB : 螺纹钢
RU : 天然橡胶
SN : 锡
WR : 线材
ZN : 锌
SP : 纸浆
SS : 不锈钢
AP : 苹果
CF : 棉花
CY : 棉纱
FG : 玻璃
GN : 绿豆
JR : 粳稻谷
LR : 晚籼稻
MA : 甲醇
ME : 甲醇-旧
PM : 普麦
ER : 早籼稻-旧
RI : 早籼稻
RM : 菜籽粕
RO : 菜籽油-旧
OI : 菜籽油
RS : 油菜籽
SF : 硅铁
SM : 锰硅
SR : 白糖
TA : PTA
TC : 动力煤-旧
ZC : 动力煤
WH : 强麦
WS : 强麦-旧
WT : 硬白小麦
CJ : 红枣
UR : 尿素
SA : 纯碱
A : 豆一
B : 豆二
BB : 胶合板
C : 玉米
CS : 玉米淀粉
FB : 纤维板
I : 铁矿石
J : 焦炭
JD : 鸡蛋
JM : 焦煤
L : 聚乙烯
M : 豆粕
P : 棕榈油
PP : 聚丙烯
V : 聚氯乙烯
Y : 豆油
EG : 乙二醇
EB : 苯乙烯
PG : 液化石油气
RR : 粳米
LH : 生猪
BC : 国际铜
IM : 中证1000
PF : 短纤
PK : 花生